WE ./path_to_the_west_texture
NO ./path_to_the_north_texture
SO ./path_to_the_south_texture
EA ./path_to_the_east_texture

F 220,99,0
C 225,30,0
11111111111111111111111111
1111111111111111111111111
 1000000000000111111111111
100000S000000000000000001
1000000000000000000000001
1000000000000000000000001
1100000111000001110000001
11111111 1111111 11111111
