WE ./texture/lion.xpm
NO ./texture/rabbit.xpm
SO ./texture/cat.xpm
EA ./texture/risu.xpm

F 221,238,255
C 170,187,238
1111111111111111111111111
1000000000000000000000001
1000000000000000000000001
1000000000000111111111111
10E0000000000000000000001
1000000000000000000000001
1000000000000000000000001
1000000000000000000000001
1000000000000000000000001
1000000000000000000000001
1000000000000000000000001
1100000111000001110000001
11111111 1111111 11111111
