SO ./path_to_the_south_texture
WE ./path_to_the_west_texture
NO ./path_to_the_north_texture
EA ./path_to_the_east_texture

F 220,100,0
C 225,30,0

1111111111111111111111111
1000000000000000000000001
1000000000000000000000001
1000000000000111111111111
10000000000000000000S0000
1000000000000000000000001
1000000000000000000000001
1000000000000000000000001
1000000000000000000000001
1000000000000000000000001
1000000000000000000000001
1100000111000001110000001
10000001 1000001 10000001
11111111 1111111 11111111
