NO ./texture/bluebird_fired_text.xpm
SO ./texture/bluebird_fired_text.xpm
WE ./texture/bluebird_fired_text.xpm
EA ./texture/bluebird_fired_text.xpm
F 220,100,0
C 225,30,0
1111111111111111111111111111
100000000011000001110111111111111
11110111111111011100000010001
11110111111111011101010010001
11000000110101011100000010001
1000S000000000001100000010001
10000000000000001101010010001
110000011101010111110111100111
11110111 1110101 101111010001
11111111 1111111 111111111111
