NO ./texture/neko.xpm
SO ./texture/neko.xpm
WE ./texture/neko.xpm
EA ./texture/neko.xpm
F 220,100,0
C 225,30,0

11111111111111111111111111111
1000000000N000001101010010001
110000011101010111110111100111
11111111 1111111 111111111111
