NO ./texture/bluebird_fired_text.xpm
SO ./texture/cat.xpm
WE ./texture/neko.xpm
EA ./texture/tori.xpm
C 128,128,0
F 137,189,222
1111111111111111111111111
1N00000000001000100000001
1111100010111010100000111
1000100010000010101010001
1011100111111110101011101
1010000010000010101000101
1010100010111010101110101
1010100000100000100000101
1010100111111011111011101
1010100000001010001010001
1010110111101010101010111
1010000000101010100010001
1011100111101010111111101
1000100000001010101000001
1110100011111010101011101
1000100000001010001010001
1011110110101110111010111
1010000010100000100010001
1011100010111111101111101
1000000010001000001010001
1111110011101011111010111
1000000010001010000010101
1000110011111010101110101
1000000000000010100000001
1111111111111111111111111
