NO ./texture/kirin.xpm
SO ./texture/kirin.xpm
WE ./texture/kirin.xpm
EA ./texture/kirin.xpm
F 220,100,0
C 225,30,0
111111111111111111111111111111
111111111111111111111111111111
111111111111111111111111111111
